* * * * * * * * *
*               * 
*   * * *   * * * 
*       *       * 
*   *   * * *   * 
*   *       *   * 
*   * * *   * * * 
*       *       * 
* * * * * * * * * 
